1111111111111111111111111111111111
1E0000000000000C00000C000000000001
1010010100100000101001000000010101
10100100101010100010010000000101C1
1P000D000C00C00000000000000D000001
1111111111111111111111111111111111
