1111111111111111111
10010000000C0000001
1C00011111000000001
1P0011E0000000C0001
1111111111111111111
